################################################.#############################################
#########################################...#####.#######.####################################
###############################...........................####################################
###############################.y.........^.....G..............###############################
###################################^^#############...C...B.....###############################
##########################.###################.....#######.....###############################
########.......................................#############..################################
########..........................#########################...################################
########......C...........R..........######################..#################################
########...#######...###############...###################...#################################
########.r.#######...#################.###################..##################################
########...########...###########.####.##################...##################################
########^^^########........................................###################################
####################......................................####################################
####################.........^...R............C.......B..#####################################
#######################...################..#####..###########################################
#####.################...#################..####..############################################
#####...................############........###..#############################################
#####..................#############........###.##############################################
####.Y.P..............####...........b......###..#############################################
####.########....#########.###############..####.#############################################
####.#########....########.##############...####..################........................####
####.##########.............................#####.......##########........................####
####.###########........................................##########...........#.#.#......A.####
####.############........................R..............##########.......#..........##########
####.##########################.......###############..###########..................##########
####.##########################......###############..############..........#..#....##########
####.##########################.....##############..................................##########
####.##########################^^^^###############...#................#...........############
####.#############################################............................##....##########
####..............................................Y#..Y.......C.....#.....##........##########
#####################################################..###########^^^^^^^^^^^^^^^^^^##########
#################################....vv....vv.................################################
########################.......vv....................C........################################
########################.............................#............####v#######################
########################.g...^....^^....^^....^^.B..###..B.............#######################
##############################################################################################
==============================================================================================