.....................................................................................................
.....................................................................................................
..........................................................A..........................................
.......................o..........................................................o..................
..............o......................................................................................
...................#######....................o...................o............................C.....
......P....................................................~~~~~~~=====================....D.........
=============###########===========~~~~~======##############################=========^^^^^==########=