................................................................................A....................
.....................................................................................................
.............o...................................o...................................................
...................######.....................................o......................................
......P..............................................~~~~~~~=====================.............C......


https://lmarena.ai/c/c0f9eb07-ce99-4499-834b-17266d2dfb0a
https://lmarena.ai/c/c0f9eb07-ce99-4499-834b-17266d2dfb0a


=============##########===========~~~~~======##############################=========^^^^^==########==